S . . # . . . . . G
# # . # . # # # . #
. . . . . . . # . #
. # # # # # . # . #
. . . . . # . # . .
. # . # . # . # # .
. # . # . # . . . .
. # . # . . . # # #
. # . . . # . . . .
. . . # . . . # K #
