S..#.....G
##.#.###.#
.......#.#
.#####.#.#
.....#.##.
.#.#.#.##.
.#.#.#....
.#.#...###
.#...#....
...#...#.#