    {S, ., ., #, ., ., ., ., ., #},
    {#, #, ., #, ., #, #, #, ., #},
    {., ., ., ., ., ., ., ., #, #},
    {., #, #, #, #, #, ., ., #, #},
    {., ., ., ., ., #, ., ., #, .},
    {., #, ., #, ., #, ., #, #, .},
    {., #, ., #, ., #, ., ., ., .},
    {., #, ., #, ., ., ., #, #, .},
    {., #, ., ., ., #, ., ., ., .},
    {., ., ., #, ., ., ., #, K, G}
